1111111111111
100100C0000C1
100C011000001
100C011111001
1P0011E000C01
100C01100E001
1111111111111